...##########################################################
...#.....#.....#..#.....#.....#..#..#....................#..#
#..####..#..####..#..#..####..#..#..#######..#######..#..#..#
#........#........#..#..#.....#..#........#..#........#.....#
#######..#######..#..#######..#..#..#############..#######..#
#...........#........#.....#..#..............#........#.....#
#..#..####..####..####..####..####..###################..####
#..#..#.....#..#........#.....#.............................#
#..##########..####..#..#..#######..#..#######..#..##########
#.....#...........#..#........#..#..#..#..#.....#...........#
#..#..#..#######..#######..#..#..#######..#..#..#..#..#######
#..#..#..#..#..#...........#.....#........#..#..#..#........#
#..#######..#..####..#..#..####..#..#..#######..#..##########
#...........#..#.....#..#..#.....#..#........#..#...........#
#..#..####..#..####..####..####..##########..####..##########
#..#..#..#..#..#.....#.....#..#..#.....#..#..#..#.....#..#..#
#..####..#..#..####..####..#..####..####..#..#..#..####..#..#
#.....#..............#.....#..#.....#.......................#
#..#..####..#..#############..#..#..####..#..#..#######..#..#
#..#.....#..#..............#.....#..#.....#..#.....#.....#..#
#######..#############..#..####..##########..#..####..#..#..#
#..#.....#........#.....#..#.................#.....#..#..#..#
#..#############..#..#..##########..#..####..####..####..####
#..#..#.....#..#.....#..............#.....#.....#..#........#
#..#..#..#..#..##########..####..####..####..####..#..####..#
#..#.....#........#...........#..#..#.....#..#.....#.....#..#
#..##########..####..#############..#..####..#############..#
#...........#.................#..#..#..#........#........#..#
#..#..#..#######..#..#..#..####..#..##########..#######..#..#
#..#..#..#........#..#..#..#..#..#..#........#........#..#..#
####..#..#..#..#######..####..#..#..#..#######..####..#..#..#
#.....#.....#.....#..#.....#...........#.....#.....#.....#..#
#..####..##########..#..####..#..####..####..####..#######..#
#.....#........#..#........#..#..#........#........#........#
#..#..##########..#############..####..####..#######..#######
#..#..#..#........#........#.....#..#..#........#........#..#
#..####..#######..####..####..####..#..#..#############..#..#
#........#..............#.....#.....#........#.....#..#.....#
#..#######..#..#..#..####..#..#..####..####..####..#..####..#
#........#..#..#..#........#..#........#........#...........
##########################################################..
