..#######################################
..........#.#...................#.......#
#.#.#.#.#.#.#.###.###.#.#####.#.#.#.#####
#.#.#.#.#.#.#.#.#...#.#.....#.#...#...#.#
###.###.#.#.###.#######.#######.###.###.#
#...#...#.#.#...........#.......#.#.#...#
#.#######.#.#.#.#####.#######.#.#.#.###.#
#...#...#...#.#...#...#.......#.#.#...#.#
#.#####.#.#####.###.###.###.#.###.###.#.#
#...#.#...........#...#.#...#.#.........#
###.#.#.#.###.###.###.#########.#####.###
#...#...#.#.#.#...#.#.#.#.#...#.#...#...#
###.#####.#.###.#.#.###.#.#.#.#.###.#####
#...#.#.....#.#.#.#...#...#.#...........#
#####.###.###.###.#.#.###.#.#########.###
#...#.#...#...#...#.#.#.....#...#.#.....#
#.#.#.#####.#.#.#####.#.#######.#.#.#####
#.#.#...#...#.....#.#.........#.#.....#.#
#.#.###.#.###.#####.#.#.###.###.###.###.#
#.#.......#.#...#.#.#.#.#...#.....#.....#
###.#####.#.#####.#.#.#.###.#.#######.#.#
#.#...#.........#.....#.#.#.#...#.#...#.#
#.#.#.###########.#.#####.###.###.#######
#.#.#.#...........#...#...#.....#.......#
#.#.#################.###.###.###.#####.#
#.....#.#.#.#.....#...........#.#...#...#
#.#.###.#.#.###.#######.#####.#.###.#####
#.#.......#.#.....#.....#...........#.#.#
###.#####.#.#####.#########.#.#####.#.#.#
#...#.....#.#.....#.......#.#.....#...#.#
#.#####.###.#####.#.#####.#####.#.#####.#
#.....#...#...#...#.....#.....#.#.#...#.#
#######.#.#.#.#.###.#########.#.###.#.#.#
#.......#...#.#.......#...#.#.#.#.#.#...#
###.#####.###.#.###.###.###.###.#.###.###
#.....#.....#.....#.....#.#.#...#.....#.#
#.#.#.#.###.#.###.###.###.#.#######.#.#.#
#.#.#.#.#...#.#...#.........#.....#.#...#
#.###.#.###########.#########.#.#.#.#.###
#...#.#.......#...............#.#...#...
#######################################.