...##########################################################
............#...........#........#.....#........#...........#
#..#..#..#######..#######..####..#..####..#############..####
#..#..#.....#.................#...........#........#........#
##########..#######..####..######################..#..####..#
#..............#........#........#..#.....#..............#..#
#######..#######..#..#..####..####..####..#######..#..#######
#.....#..#........#..#.....#..#..#.....#........#..#........#
#..####..####..#######..#..####..####..####..#..#..#######..#
#..............#.....#..#....................#...........#..#
#..####..#..#..#..####..#######..#..####..#..##########..####
#.....#..#..#..#.....#..#.....#..#..#.....#.....#..#........#
#..#..####..####..####..#..#############..#..#..#..#..#######
#..#..#..............#.....#.....#..#.....#..#.....#........#
#..#######..#######..####..#..#..#..#..#######..#..#..####..#
#..#.....#..#..#........#.....#..#..#..#........#..#.....#..#
#..####..####..####..#..##########..#######..#..####..#######
#...........#........#........#.....#..#..#..#..#..#........#
#..#..#######..#######..##########..#..#..#..####..#..####..#
#..#........#.....#........#.................#.....#..#.....#
##########..#######..####..#..####..####..#..#..#######..####
#..#.....#.....#.....#.....#..#........#..#...........#.....#
#..#..#..#..#######..#..##########..##########..####..####..#
#.....#..#.....#..#..#.....#...........#........#........#..#
####..#..#..####..##########..##########..#..####..####..#..#
#.....#.....#..#.....#..#..#........#.....#..#.....#.....#..#
#######..####..#..####..#..##########..#############..####..#
#..#.............................#........#.....#.....#..#..#
#..####..####..#######..#######..####..#..####..#######..####
#..#.....#........#..#........#..#..#..#...........#........#
#..####..#..####..#..####..#######..#######..#######..#..#..#
#........#..#.....#.....#..#..#..#........#...........#..#..#
#######..#############..#..#..#..#######..#..#######..####..#
#..#.....#.....#..#...........#........#........#..#..#.....#
#..#..####..####..################..####..####..#..#..#..####
#..#..#..#.....#..............#........#..#..#..#.....#.....#
#..#..#..#..#..#############..####..####..#..#######..#..####
#..#........#...........#.....#..#...........#..#.....#..#..#
#..####..##########..#..#..####..#..#..#######..#..#######..#
#.................#..#.....#........#...........#...........
##########################################################..
